x,y,n,e,s,w,sx,sy,gx,gy
0,0,0,1,1,1,0,0,7,7
1,0,0,0,1,1,0,0,7,7
2,0,1,0,1,0,0,0,7,7
3,0,1,0,1,0,0,0,7,7
4,0,1,0,1,0,0,0,7,7
5,0,1,0,1,0,0,0,7,7
6,0,1,0,1,0,0,0,7,7
7,0,0,1,1,0,0,0,7,7
0,1,0,1,0,1,0,0,7,7
1,1,0,0,0,1,0,0,7,7
2,1,1,0,1,0,0,0,7,7
3,1,0,0,1,0,0,0,7,7
4,1,1,0,1,0,0,0,7,7
5,1,0,1,1,0,0,0,7,7
6,1,0,0,1,1,0,0,7,7
7,1,1,1,0,0,0,0,7,7
0,2,0,0,0,1,0,0,7,7
1,2,1,1,0,0,0,0,7,7
2,2,0,0,1,1,0,0,7,7
3,2,1,0,0,0,0,0,7,7
4,2,1,0,1,0,0,0,7,7
5,2,1,1,0,0,0,0,7,7
6,2,0,1,0,1,0,0,7,7
7,2,0,1,1,1,0,0,7,7
0,3,0,1,0,1,0,0,7,7
1,3,0,0,1,1,0,0,7,7
2,3,1,1,0,0,0,0,7,7
3,3,0,1,1,1,0,0,7,7
4,3,0,0,1,1,0,0,7,7
5,3,0,1,1,0,0,0,7,7
6,3,0,1,0,1,0,0,7,7
7,3,0,1,0,1,0,0,7,7
0,4,0,1,0,1,0,0,7,7
1,4,1,0,0,1,0,0,7,7
2,4,1,0,1,0,0,0,7,7
3,4,0,1,0,0,0,0,7,7
4,4,0,1,0,1,0,0,7,7
5,4,0,0,0,1,0,0,7,7
6,4,0,1,0,0,0,0,7,7
7,4,1,1,0,1,0,0,7,7
0,5,0,1,0,1,0,0,7,7
1,5,0,0,1,1,0,0,7,7
2,5,0,1,1,0,0,0,7,7
3,5,0,0,0,1,0,0,7,7
4,5,1,1,0,0,0,0,7,7
5,5,1,1,0,1,0,0,7,7
6,5,0,0,0,1,0,0,7,7
7,5,0,1,1,0,0,0,7,7
0,6,1,0,0,1,0,0,7,7
1,6,1,1,0,0,0,0,7,7
2,6,0,1,0,1,0,0,7,7
3,6,0,1,0,1,0,0,7,7
4,6,0,0,1,1,0,0,7,7
5,6,1,0,1,0,0,0,7,7
6,6,1,1,0,0,0,0,7,7
7,6,0,1,0,1,0,0,7,7
0,7,1,0,1,1,0,0,7,7
1,7,1,1,1,0,0,0,7,7
2,7,1,0,0,1,0,0,7,7
3,7,1,0,0,0,0,0,7,7
4,7,1,1,0,0,0,0,7,7
5,7,1,0,1,1,0,0,7,7
6,7,1,1,1,0,0,0,7,7
7,7,1,1,0,1,0,0,7,7
