9 1 1 5 1 5 1 5 1 5 5 3 d 1 1 3 
a a a 9 6 9 4 7 c 3 9 0 3 a e a 
a a 8 2 9 4 1 3 b a a a 8 0 5 2 
c 0 6 8 6 9 2 a 8 0 6 a a 8 3 a 
b a 9 4 5 6 a a a a b a a a 8 2 
a 8 2 9 5 5 6 a a c 2 a c 0 6 a 
8 6 c 4 5 1 7 c 6 9 6 c 5 0 5 2 
a d 1 5 5 0 3 9 3 c 3 9 5 0 5 2 
8 5 0 5 3 a a c 2 d 6 a d 0 7 a 
e 9 0 7 a a 8 3 8 5 3 a d 0 7 a 
9 6 a d 2 a e a c 3 a a d 0 7 a 
c 3 8 1 2 c 1 6 b c 2 8 7 a d 2 
9 6 a a 8 5 6 9 0 3 c 4 5 4 7 a 
a 9 2 a a 9 3 a a c 5 3 b b b a 
a a 8 0 6 a a c 4 5 3 8 2 8 2 a 
e c 6 c 5 6 c 5 5 5 6 e c 6 c 6 
